12 12 2
1 1 1 1 1 1 1 1 1 1 1 1
1 0 0 0 0 1 0 0 0 0 0 1
1 0 3 3 0 0 0 0 0 0 0 1
1 0 3 3 0 0 0 0 0 0 0 1
1 0 0 0 0 0 0 0 0 0 0 1
1 0 0 0 0 5 0 0 0 0 0 1
1 0 0 0 0 6 0 0 0 0 0 1
1 0 0 0 0 6 0 0 1 1 1 1
1 0 0 0 0 6 0 0 0 0 0 1
1 0 0 0 0 6 0 0 0 0 0 1
1 0 0 0 0 6 0 0 0 0 0 1
1 1 1 1 1 1 1 1 1 1 1 1